NO          /nfs/homes/mneri/Projects/cub3d/texture/wall_N.xpm
SO          /nfs/homes/mneri/Projects/cub3d/texture/wall_S.xpm
WE         /nfs/homes/mneri/Projects/cub3d/texture/wall_W.xpm
EA        /nfs/homes/mneri/Projects/cub3d/texture/wall_E.xpm
F     220,100,0 
C 220,30,0 
        1111111111111111111111111
       10000000001100000000000001  
        1011000001110000000000001
        1001000000000000000000001
111111111011000001110000000000001 
100000000011000001110111111111111
11110111111111011100000010001
11110111111111011101010010001
11000000110101011100000010001
10000000000000001100W000100001
10000000000000001101010010001
1100000111010101111101111000111
11110111 1110101 101111010001
11111111 1111111 11111111111
